33333333333
34111011413
31121111113
31111121113
31141121113
33333333333