33333333333
31211411013
31121111113
31111141113
31141121113
33333333333