33333333333333333
34111011411111413
31121111121111113
31111123112111113
31141121111111413
33333333333333333