33333331111
31111013111
31111213333
31141111113
33111112113
13341111113
11333333333
