3333333333333333333333333333333333
3031131111311111131113111131411133
3111111111111111111111111211111113
3311121111111111111111111111111133
3411111111131313321111141211111113
3311111111132321311111111111111143
3411111111131313321111111211111133
3311111111111111111111411111111113
3311111111111111111211111111111113
3411311111311411131111131413113113
3333333333333333333333333333333333
