3333333333333333
3301111111111143
3111111211111113
3111113331111113
3141123332111113
3111111211111113
3111111111111113
3111111111111113
3114111111141133
3333333333333333
